10 7
##########
#        #
#  $   @ #
#    #   #
#  .     #
#        #
##########